---------------------------------------------------------------------------------------------
-######################-----------##########################################################-
-###########################################################################################-
-###########################################################################################-
---------------------------------------------------------------------------------------------